1111111111111
10010C0000001
1000011111001
101011E000C01
1P0B000000001
1111111111111